0111101101
0000000001
1001000000
1001000001
1001000001
0000000000
0001000000
0000000000
0010001001
0000000000